Name: projectile scavenger hunt shipping 	Sector ID: 561
Name: weaponized jellybean technology 	Sector ID: 436
Name: biohazardous basket customer service 	Sector ID: 253
Name: cryogenic bunny customer service 	Sector ID: 425
Name: classified plastic grass purchasing 	Sector ID: 616
Name: projectile candy coating technology 	Sector ID: 111
Name: corrosive egg services 	Sector ID: 805
Name: corrosive chocolate engineering 	Sector ID: 534
Name: military grade bunny management 	Sector ID: 685
Name: international basket engineering 	Sector ID: 853
Name: cryogenic biohazardous dye marketing 	Sector ID: 614
Name: weaponized chocolate services 	Sector ID: 493
Name: consumer grade chocolate deployment 	Sector ID: 798
Name: fuzzy dye deployment 	Sector ID: 678
Name: consumer grade bunny management 	Sector ID: 175
Name: colorful flower marketing 	Sector ID: 401
Name: cryogenic plastic grass management 	Sector ID: 567
Name: cryogenic bunny research 	Sector ID: 122
Name: military grade chocolate acquisition 	Sector ID: 609
Name: top secret scavenger hunt training 	Sector ID: 981
Name: corrosive chocolate receiving 	Sector ID: 716
Name: cryogenic bunny receiving 	Sector ID: 922
Name: consumer grade plastic grass training 	Sector ID: 916
Name: fuzzy basket reacquisition 	Sector ID: 530
Name: projectile candy coating reacquisition 	Sector ID: 688
Name: projectile rabbit user testing 	Sector ID: 462
Name: projectile egg training 	Sector ID: 355
Name: rampaging flower department 	Sector ID: 822
Name: radioactive candy containment 	Sector ID: 764
Name: magnetic basket laboratory 	Sector ID: 782
Name: military grade plastic grass containment 	Sector ID: 432
Name: weaponized chocolate logistics 	Sector ID: 271
Name: biohazardous plastic grass shipping 	Sector ID: 465
Name: magnetic scavenger hunt operations 	Sector ID: 398
Name: colorful classified jellybean workshop 	Sector ID: 143
Name: top secret bunny management 	Sector ID: 242
Name: fuzzy basket department 	Sector ID: 412
Name: top secret bunny financing 	Sector ID: 477
Name: cryogenic bunny technology 	Sector ID: 174
Name: fuzzy bunny logistics 	Sector ID: 251
Name: colorful scavenger hunt technology 	Sector ID: 229
Name: corrosive international candy coating development 	Sector ID: 609
Name: magnetic egg development 	Sector ID: 726
Name: top secret chocolate development 	Sector ID: 456
Name: biohazardous dye research 	Sector ID: 784
Name: fuzzy consumer grade plastic grass services 	Sector ID: 648
Name: radioactive basket sales 	Sector ID: 742
Name: cryogenic candy coating services 	Sector ID: 927
Name: fuzzy flower purchasing 	Sector ID: 306
Name: radioactive corrosive flower deployment 	Sector ID: 220
Name: rampaging unstable basket workshop 	Sector ID: 506
Name: rampaging candy purchasing 	Sector ID: 813
Name: radioactive classified plastic grass financing 	Sector ID: 634
Name: top secret plastic grass containment 	Sector ID: 506
Name: biohazardous egg analysis 	Sector ID: 140
Name: colorful military grade egg deployment 	Sector ID: 577
Name: consumer grade bunny marketing 	Sector ID: 250
Name: international candy coating research 	Sector ID: 223
Name: top secret scavenger hunt workshop 	Sector ID: 947
Name: top secret plastic grass technology 	Sector ID: 213
Name: top secret flower receiving 	Sector ID: 539
Name: consumer grade candy coating services 	Sector ID: 661
Name: magnetic scavenger hunt storage 	Sector ID: 353
Name: weaponized candy coating marketing 	Sector ID: 489
Name: international basket analysis 	Sector ID: 452
Name: military grade plastic grass research 	Sector ID: 471
Name: projectile candy research 	Sector ID: 406
Name: biohazardous egg workshop 	Sector ID: 848
Name: unstable candy department 	Sector ID: 594
Name: unstable dye user testing 	Sector ID: 140
Name: radioactive scavenger hunt reacquisition 	Sector ID: 999
Name: fuzzy plastic grass technology 	Sector ID: 484
Name: colorful international basket marketing 	Sector ID: 791
Name: classified consumer grade bunny research 	Sector ID: 937
Name: projectile candy containment 	Sector ID: 510
Name: cryogenic flower containment 	Sector ID: 362
Name: radioactive rabbit services 	Sector ID: 957
Name: radioactive dye department 	Sector ID: 384
Name: consumer grade basket research 	Sector ID: 925
Name: weaponized basket receiving 	Sector ID: 739
Name: fuzzy egg logistics 	Sector ID: 233
Name: unstable candy reacquisition 	Sector ID: 297
Name: rampaging candy coating development 	Sector ID: 508
Name: radioactive candy coating storage 	Sector ID: 295
Name: magnetic jellybean storage 	Sector ID: 127
Name: magnetic basket sales 	Sector ID: 871
Name: projectile dye development 	Sector ID: 601
Name: international rabbit user testing 	Sector ID: 492
Name: military grade candy containment 	Sector ID: 341
Name: consumer grade rabbit deployment 	Sector ID: 785
Name: consumer grade egg reacquisition 	Sector ID: 483
Name: colorful jellybean services 	Sector ID: 590
Name: projectile cryogenic candy user testing 	Sector ID: 115
Name: top secret flower analysis 	Sector ID: 404
Name: rampaging plastic grass development 	Sector ID: 716
Name: projectile dye engineering 	Sector ID: 519
Name: consumer grade candy coating development 	Sector ID: 808
Name: international magnetic flower research 	Sector ID: 877
Name: international egg services 	Sector ID: 629
Name: unstable military grade candy coating management 	Sector ID: 126
Name: projectile candy coating operations 	Sector ID: 793
Name: cryogenic colorful candy services 	Sector ID: 630
Name: weaponized candy customer service 	Sector ID: 836
Name: colorful flower reacquisition 	Sector ID: 977
Name: consumer grade weaponized basket engineering 	Sector ID: 294
Name: magnetic bunny logistics 	Sector ID: 656
Name: rampaging plastic grass reacquisition 	Sector ID: 463
Name: magnetic dye engineering 	Sector ID: 703
Name: unstable scavenger hunt containment 	Sector ID: 118
Name: classified candy coating purchasing 	Sector ID: 658
Name: corrosive dye sales 	Sector ID: 112
Name: radioactive plastic grass shipping 	Sector ID: 975
Name: biohazardous classified chocolate purchasing 	Sector ID: 178
Name: fuzzy rabbit services 	Sector ID: 585
Name: corrosive bunny research 	Sector ID: 651
Name: weaponized chocolate user testing 	Sector ID: 943
Name: classified magnetic scavenger hunt design 	Sector ID: 524
Name: classified bunny technology 	Sector ID: 638
Name: weaponized plastic grass development 	Sector ID: 363
Name: military grade bunny receiving 	Sector ID: 472
Name: corrosive flower sales 	Sector ID: 277
Name: radioactive flower engineering 	Sector ID: 453
Name: weaponized rabbit purchasing 	Sector ID: 658
Name: consumer grade dye laboratory 	Sector ID: 403
Name: international candy coating analysis 	Sector ID: 995
Name: weaponized jellybean customer service 	Sector ID: 269
Name: top secret jellybean design 	Sector ID: 211
Name: fuzzy unstable bunny financing 	Sector ID: 419
Name: rampaging basket storage 	Sector ID: 285
Name: cryogenic plastic grass customer service 	Sector ID: 190
Name: cryogenic egg logistics 	Sector ID: 555
Name: fuzzy candy coating storage 	Sector ID: 581
Name: projectile jellybean analysis 	Sector ID: 550
Name: cryogenic basket shipping 	Sector ID: 360
Name: rampaging cryogenic candy coating logistics 	Sector ID: 607
Name: top secret scavenger hunt receiving 	Sector ID: 617
Name: fuzzy candy coating training 	Sector ID: 114
Name: rampaging candy research 	Sector ID: 623
Name: unstable flower deployment 	Sector ID: 316
Name: rampaging magnetic bunny design 	Sector ID: 773
Name: fuzzy scavenger hunt shipping 	Sector ID: 118
Name: fuzzy chocolate laboratory 	Sector ID: 403
Name: corrosive scavenger hunt research 	Sector ID: 852
Name: top secret flower customer service 	Sector ID: 915
Name: colorful egg development 	Sector ID: 712
Name: radioactive flower shipping 	Sector ID: 758
Name: rampaging basket purchasing 	Sector ID: 867
Name: colorful egg receiving 	Sector ID: 609
Name: magnetic dye shipping 	Sector ID: 979
Name: unstable chocolate operations 	Sector ID: 921
Name: top secret rabbit containment 	Sector ID: 440
Name: classified candy coating sales 	Sector ID: 756
Name: cryogenic flower development 	Sector ID: 827
Name: biohazardous military grade rabbit analysis 	Sector ID: 123
Name: cryogenic jellybean laboratory 	Sector ID: 153
Name: fuzzy scavenger hunt workshop 	Sector ID: 695
Name: radioactive bunny reacquisition 	Sector ID: 215
Name: consumer grade dye reacquisition 	Sector ID: 600
Name: cryogenic candy coating receiving 	Sector ID: 606
Name: radioactive unstable egg containment 	Sector ID: 526
Name: weaponized chocolate receiving 	Sector ID: 674
Name: unstable jellybean development 	Sector ID: 932
Name: colorful chocolate deployment 	Sector ID: 259
Name: projectile candy coating design 	Sector ID: 770
Name: international dye operations 	Sector ID: 596
Name: consumer grade jellybean research 	Sector ID: 393
Name: projectile chocolate technology 	Sector ID: 744
Name: consumer grade jellybean department 	Sector ID: 695
Name: consumer grade chocolate management 	Sector ID: 145
Name: unstable rabbit laboratory 	Sector ID: 748
Name: military grade chocolate user testing 	Sector ID: 623
Name: rampaging candy logistics 	Sector ID: 756
Name: international scavenger hunt containment 	Sector ID: 137
Name: international flower technology 	Sector ID: 946
Name: magnetic candy coating purchasing 	Sector ID: 263
Name: magnetic chocolate operations 	Sector ID: 597
Name: top secret candy shipping 	Sector ID: 647
Name: consumer grade bunny laboratory 	Sector ID: 750
Name: rampaging flower shipping 	Sector ID: 270
Name: classified flower design 	Sector ID: 365
Name: military grade bunny acquisition 	Sector ID: 530
Name: weaponized bunny shipping 	Sector ID: 332
Name: fuzzy egg services 	Sector ID: 108
Name: international candy coating customer service 	Sector ID: 275
Name: military grade scavenger hunt research 	Sector ID: 839
Name: classified candy acquisition 	Sector ID: 116
Name: radioactive rabbit development 	Sector ID: 894
Name: consumer grade international plastic grass acquisition 	Sector ID: 523
Name: cryogenic basket department 	Sector ID: 432
Name: candy coating deployment 	Sector ID: 632
Name: corrosive projectile bunny engineering 	Sector ID: 530
Name: international rabbit financing 	Sector ID: 138
Name: military grade weaponized chocolate deployment 	Sector ID: 586
Name: military grade rampaging bunny engineering 	Sector ID: 793
Name: military grade jellybean customer service 	Sector ID: 612
Name: rampaging dye reacquisition 	Sector ID: 357
Name: military grade candy coating user testing 	Sector ID: 120
Name: radioactive flower management 	Sector ID: 655
Name: rampaging candy coating receiving 	Sector ID: 840
Name: consumer grade dye research 	Sector ID: 900
Name: biohazardous plastic grass operations 	Sector ID: 539
Name: weaponized scavenger hunt customer service 	Sector ID: 185
Name: rampaging plastic grass financing 	Sector ID: 734
Name: military grade consumer grade candy coating sales 	Sector ID: 817
Name: fuzzy basket receiving 	Sector ID: 488
Name: consumer grade scavenger hunt purchasing 	Sector ID: 952
Name: fuzzy basket workshop 	Sector ID: 447
Name: unstable colorful jellybean operations 	Sector ID: 113
Name: unstable jellybean receiving 	Sector ID: 215
Name: military grade scavenger hunt operations 	Sector ID: 295
Name: cryogenic jellybean department 	Sector ID: 661
Name: corrosive basket laboratory 	Sector ID: 393
Name: radioactive basket marketing 	Sector ID: 668
Name: projectile plastic grass sales 	Sector ID: 206
Name: biohazardous fuzzy scavenger hunt research 	Sector ID: 163
Name: colorful basket shipping 	Sector ID: 471
Name: biohazardous consumer grade candy coating training 	Sector ID: 419
Name: radioactive chocolate acquisition 	Sector ID: 393
Name: radioactive scavenger hunt user testing 	Sector ID: 860
Name: projectile candy acquisition 	Sector ID: 562
Name: fuzzy bunny management 	Sector ID: 570
Name: top secret candy coating laboratory 	Sector ID: 171
Name: weaponized plastic grass containment 	Sector ID: 159
Name: classified flower logistics 	Sector ID: 657
Name: top secret dye financing 	Sector ID: 852
Name: fuzzy candy coating development 	Sector ID: 615
Name: classified candy workshop 	Sector ID: 838
Name: top secret chocolate containment 	Sector ID: 859
Name: classified scavenger hunt shipping 	Sector ID: 622
Name: projectile bunny user testing 	Sector ID: 446
Name: projectile dye laboratory 	Sector ID: 109
Name: weaponized flower marketing 	Sector ID: 128
Name: magnetic plastic grass workshop 	Sector ID: 107
Name: colorful candy coating financing 	Sector ID: 759
Name: magnetic egg user testing 	Sector ID: 697
Name: top secret plastic grass design 	Sector ID: 361
Name: fuzzy bunny acquisition 	Sector ID: 163
Name: top secret flower reacquisition 	Sector ID: 375
Name: corrosive basket technology 	Sector ID: 498
Name: consumer grade jellybean design 	Sector ID: 691
Name: weaponized candy coating services 	Sector ID: 409
Name: consumer grade egg technology 	Sector ID: 694
Name: fuzzy rabbit marketing 	Sector ID: 781
Name: rampaging candy acquisition 	Sector ID: 307
Name: fuzzy bunny sales 	Sector ID: 218
Name: magnetic jellybean user testing 	Sector ID: 683
Name: consumer grade plastic grass customer service 	Sector ID: 827
Name: magnetic scavenger hunt purchasing 	Sector ID: 282
Name: unstable rampaging basket technology 	Sector ID: 165
Name: magnetic scavenger hunt marketing 	Sector ID: 291
Name: weaponized egg customer service 	Sector ID: 297
Name: weaponized fuzzy chocolate services 	Sector ID: 565
Name: weaponized scavenger hunt reacquisition 	Sector ID: 779
Name: classified candy coating operations 	Sector ID: 669
Name: top secret basket workshop 	Sector ID: 704
Name: weaponized basket purchasing 	Sector ID: 727
Name: colorful rabbit services 	Sector ID: 732
Name: fuzzy rampaging plastic grass financing 	Sector ID: 687
Name: consumer grade magnetic plastic grass storage 	Sector ID: 264
Name: projectile scavenger hunt department 	Sector ID: 108
Name: rampaging magnetic basket acquisition 	Sector ID: 738
Name: consumer grade scavenger hunt acquisition 	Sector ID: 443
Name: unstable chocolate deployment 	Sector ID: 980
Name: consumer grade chocolate laboratory 	Sector ID: 574
Name: international dye laboratory 	Sector ID: 424
Name: corrosive flower design 	Sector ID: 110
Name: consumer grade rabbit receiving 	Sector ID: 210
Name: magnetic plastic grass user testing 	Sector ID: 432
Name: corrosive bunny logistics 	Sector ID: 811
Name: consumer grade chocolate development 	Sector ID: 939
Name: weaponized jellybean user testing 	Sector ID: 361
Name: classified rabbit shipping 	Sector ID: 287
Name: colorful dye training 	Sector ID: 303
Name: fuzzy consumer grade basket engineering 	Sector ID: 809
Name: classified chocolate shipping 	Sector ID: 447
Name: consumer grade egg engineering 	Sector ID: 917
Name: cryogenic projectile chocolate services 	Sector ID: 357
Name: rampaging plastic grass receiving 	Sector ID: 687
Name: weaponized jellybean operations 	Sector ID: 750
Name: consumer grade plastic grass analysis 	Sector ID: 216
Name: top secret candy reacquisition 	Sector ID: 917
Name: cryogenic rabbit technology 	Sector ID: 451
Name: magnetic plastic grass training 	Sector ID: 939
Name: fuzzy rabbit storage 	Sector ID: 288
Name: international jellybean engineering 	Sector ID: 394
Name: unstable classified candy acquisition 	Sector ID: 109
Name: classified flower department 	Sector ID: 701
Name: unstable flower analysis 	Sector ID: 158
Name: international dye purchasing 	Sector ID: 398
Name: unstable flower receiving 	Sector ID: 886
Name: consumer grade candy coating design 	Sector ID: 445
Name: military grade chocolate operations 	Sector ID: 989
Name: rampaging egg design 	Sector ID: 875
Name: consumer grade jellybean deployment 	Sector ID: 251
Name: international rampaging candy design 	Sector ID: 268
Name: colorful flower laboratory 	Sector ID: 291
Name: military grade flower analysis 	Sector ID: 465
Name: international candy coating marketing 	Sector ID: 341
Name: rampaging dye workshop 	Sector ID: 653
Name: military grade chocolate technology 	Sector ID: 873
Name: projectile egg acquisition 	Sector ID: 466
Name: projectile bunny laboratory 	Sector ID: 237
Name: top secret jellybean logistics 	Sector ID: 909
Name: rampaging flower deployment 	Sector ID: 517
Name: international top secret rabbit research 	Sector ID: 609
Name: military grade egg management 	Sector ID: 822
Name: cryogenic dye storage 	Sector ID: 839
Name: consumer grade egg design 	Sector ID: 436
Name: top secret dye customer service 	Sector ID: 531
Name: projectile dye management 	Sector ID: 196
Name: military grade rabbit laboratory 	Sector ID: 374
Name: international candy logistics 	Sector ID: 786
Name: biohazardous projectile candy customer service 	Sector ID: 194
Name: projectile candy coating acquisition 	Sector ID: 886
Name: consumer grade cryogenic plastic grass logistics 	Sector ID: 980
Name: fuzzy basket engineering 	Sector ID: 418
Name: weaponized plastic grass laboratory 	Sector ID: 611
Name: top secret candy coating storage 	Sector ID: 628
Name: military grade candy coating technology 	Sector ID: 948
Name: projectile dye research 	Sector ID: 766
Name: fuzzy chocolate analysis 	Sector ID: 711
Name: radioactive plastic grass containment 	Sector ID: 743
Name: top secret plastic grass department 	Sector ID: 788
Name: military grade candy coating marketing 	Sector ID: 512
Name: classified scavenger hunt research 	Sector ID: 683
Name: weaponized scavenger hunt acquisition 	Sector ID: 760
Name: fuzzy candy receiving 	Sector ID: 237
Name: rampaging dye engineering 	Sector ID: 725
Name: military grade basket sales 	Sector ID: 326
Name: projectile flower logistics 	Sector ID: 653
Name: projectile basket training 	Sector ID: 151
Name: international basket user testing 	Sector ID: 330
Name: consumer grade jellybean user testing 	Sector ID: 628
Name: cryogenic rabbit engineering 	Sector ID: 906
Name: magnetic dye management 	Sector ID: 287
Name: colorful jellybean marketing 	Sector ID: 439
Name: international candy coating management 	Sector ID: 193
Name: projectile weaponized jellybean design 	Sector ID: 168
Name: colorful flower management 	Sector ID: 436
Name: magnetic candy engineering 	Sector ID: 467
Name: classified candy coating marketing 	Sector ID: 443
Name: corrosive flower logistics 	Sector ID: 571
Name: international egg shipping 	Sector ID: 233
Name: top secret plastic grass storage 	Sector ID: 150
Name: cryogenic biohazardous rabbit research 	Sector ID: 584
Name: projectile plastic grass financing 	Sector ID: 119
Name: biohazardous jellybean analysis 	Sector ID: 297
Name: weaponized candy training 	Sector ID: 626
Name: projectile plastic grass services 	Sector ID: 573
Name: consumer grade candy services 	Sector ID: 647
Name: colorful jellybean operations 	Sector ID: 319
Name: consumer grade candy coating receiving 	Sector ID: 412
Name: international plastic grass containment 	Sector ID: 918
Name: military grade jellybean containment 	Sector ID: 847
Name: projectile scavenger hunt deployment 	Sector ID: 568
Name: weaponized colorful scavenger hunt user testing 	Sector ID: 272
Name: colorful scavenger hunt operations 	Sector ID: 517
Name: corrosive plastic grass marketing 	Sector ID: 380
Name: classified flower engineering 	Sector ID: 633
Name: classified scavenger hunt technology 	Sector ID: 870
Name: corrosive candy coating operations 	Sector ID: 984
Name: radioactive egg purchasing 	Sector ID: 574
Name: fuzzy candy coating receiving 	Sector ID: 672
Name: military grade candy operations 	Sector ID: 475
Name: military grade candy research 	Sector ID: 849
Name: projectile candy design 	Sector ID: 700
Name: top secret candy receiving 	Sector ID: 318
Name: weaponized flower customer service 	Sector ID: 979
Name: rampaging scavenger hunt reacquisition 	Sector ID: 823
Name: top secret jellybean deployment 	Sector ID: 656
Name: projectile jellybean financing 	Sector ID: 504
Name: biohazardous scavenger hunt receiving 	Sector ID: 579
Name: radioactive egg customer service 	Sector ID: 281
Name: corrosive radioactive bunny technology 	Sector ID: 227
Name: radioactive candy training 	Sector ID: 841
Name: classified rabbit purchasing 	Sector ID: 948
Name: weaponized jellybean financing 	Sector ID: 552
Name: corrosive plastic grass training 	Sector ID: 992
Name: fuzzy plastic grass management 	Sector ID: 232
Name: colorful top secret flower research 	Sector ID: 826
Name: international flower storage 	Sector ID: 236
Name: fuzzy jellybean research 	Sector ID: 588
Name: weaponized jellybean services 	Sector ID: 119
Name: top secret dye purchasing 	Sector ID: 136
Name: classified bunny storage 	Sector ID: 923
Name: top secret scavenger hunt services 	Sector ID: 736
Name: cryogenic rabbit laboratory 	Sector ID: 727
Name: biohazardous projectile rabbit research 	Sector ID: 412
Name: classified rabbit technology 	Sector ID: 289
Name: top secret rabbit technology 	Sector ID: 460
Name: consumer grade bunny storage 	Sector ID: 896
Name: international jellybean storage 	Sector ID: 387
Name: projectile basket receiving 	Sector ID: 582
Name: corrosive top secret plastic grass engineering 	Sector ID: 848
Name: classified plastic grass deployment 	Sector ID: 706
Name: radioactive jellybean department 	Sector ID: 924
Name: fuzzy candy coating research 	Sector ID: 369
Name: classified projectile egg engineering 	Sector ID: 647
Name: cryogenic basket customer service 	Sector ID: 269
Name: military grade dye marketing 	Sector ID: 398
Name: consumer grade unstable candy coating workshop 	Sector ID: 257
Name: consumer grade candy acquisition 	Sector ID: 790
Name: colorful jellybean customer service 	Sector ID: 161
Name: weaponized flower purchasing 	Sector ID: 920
Name: classified basket laboratory 	Sector ID: 741
Name: colorful flower operations 	Sector ID: 647
Name: colorful scavenger hunt sales 	Sector ID: 938
Name: international dye customer service 	Sector ID: 826
Name: military grade candy storage 	Sector ID: 279
Name: fuzzy rabbit design 	Sector ID: 355
Name: unstable flower acquisition 	Sector ID: 363
Name: corrosive plastic grass reacquisition 	Sector ID: 734
Name: unstable chocolate technology 	Sector ID: 506
Name: classified candy receiving 	Sector ID: 507
Name: projectile candy coating engineering 	Sector ID: 197
Name: fuzzy candy coating logistics 	Sector ID: 686
Name: consumer grade dye purchasing 	Sector ID: 337
Name: fuzzy jellybean receiving 	Sector ID: 425
Name: cryogenic unstable candy training 	Sector ID: 713
Name: colorful bunny acquisition 	Sector ID: 576
Name: fuzzy chocolate technology 	Sector ID: 536
Name: consumer grade dye customer service 	Sector ID: 786
Name: projectile flower shipping 	Sector ID: 162
Name: magnetic scavenger hunt management 	Sector ID: 201
Name: consumer grade candy operations 	Sector ID: 622
Name: cryogenic consumer grade chocolate storage 	Sector ID: 222
Name: top secret military grade bunny analysis 	Sector ID: 453
Name: radioactive plastic grass department 	Sector ID: 552
Name: fuzzy bunny engineering 	Sector ID: 458
Name: fuzzy jellybean financing 	Sector ID: 873
Name: fuzzy bunny storage 	Sector ID: 504
Name: classified egg purchasing 	Sector ID: 122
Name: colorful plastic grass research 	Sector ID: 600
Name: international egg laboratory 	Sector ID: 199
Name: biohazardous colorful candy coating user testing 	Sector ID: 412
Name: magnetic fuzzy egg reacquisition 	Sector ID: 480
Name: projectile scavenger hunt workshop 	Sector ID: 562
Name: rampaging candy engineering 	Sector ID: 804
Name: military grade jellybean workshop 	Sector ID: 327
Name: radioactive candy coating laboratory 	Sector ID: 752
Name: cryogenic rabbit storage 	Sector ID: 440
Name: unstable rabbit engineering 	Sector ID: 748
Name: consumer grade plastic grass containment 	Sector ID: 194
Name: international top secret basket purchasing 	Sector ID: 122
Name: classified plastic grass financing 	Sector ID: 594
Name: fuzzy jellybean department 	Sector ID: 219
Name: cryogenic scavenger hunt management 	Sector ID: 154
Name: colorful rabbit purchasing 	Sector ID: 674
Name: top secret rabbit user testing 	Sector ID: 241
Name: consumer grade colorful jellybean engineering 	Sector ID: 499
Name: projectile bunny workshop 	Sector ID: 902
Name: rampaging flower laboratory 	Sector ID: 846
Name: projectile bunny storage 	Sector ID: 127
Name: rampaging plastic grass sales 	Sector ID: 322
Name: corrosive jellybean marketing 	Sector ID: 434
Name: colorful basket engineering 	Sector ID: 762
Name: classified dye sales 	Sector ID: 262
Name: corrosive scavenger hunt analysis 	Sector ID: 602
Name: cryogenic rabbit sales 	Sector ID: 963
Name: magnetic chocolate design 	Sector ID: 240
Name: fuzzy egg development 	Sector ID: 613
Name: magnetic dye deployment 	Sector ID: 322
Name: corrosive plastic grass design 	Sector ID: 105
Name: rampaging military grade chocolate services 	Sector ID: 487
Name: weaponized scavenger hunt containment 	Sector ID: 825
Name: projectile candy coating research 	Sector ID: 487
Name: northpole object storage 	Sector ID: 267
Name: magnetic dye storage 	Sector ID: 541
Name: projectile flower financing 	Sector ID: 297
Name: fuzzy dye services 	Sector ID: 623
Name: unstable candy coating customer service 	Sector ID: 692
Name: rampaging flower analysis 	Sector ID: 370
Name: biohazardous jellybean customer service 	Sector ID: 852
Name: weaponized dye containment 	Sector ID: 867
Name: projectile scavenger hunt user testing 	Sector ID: 801
Name: colorful chocolate management 	Sector ID: 402
Name: unstable dye containment 	Sector ID: 919
Name: classified scavenger hunt financing 	Sector ID: 605
Name: radioactive candy engineering 	Sector ID: 820
Name: rampaging plastic grass shipping 	Sector ID: 324
Name: fuzzy candy user testing 	Sector ID: 264
Name: classified egg reacquisition 	Sector ID: 252
Name: corrosive chocolate financing 	Sector ID: 171
Name: unstable basket services 	Sector ID: 300
Name: rampaging dye marketing 	Sector ID: 469
Name: colorful candy coating reacquisition 	Sector ID: 256
Name: military grade dye acquisition 	Sector ID: 204
Name: consumer grade rampaging basket engineering 	Sector ID: 845
Name: cryogenic basket laboratory 	Sector ID: 270
Name: consumer grade top secret jellybean engineering 	Sector ID: 577
Name: unstable egg services 	Sector ID: 939
Name: weaponized dye reacquisition 	Sector ID: 321
Name: biohazardous plastic grass user testing 	Sector ID: 303
Name: biohazardous candy workshop 	Sector ID: 640
Name: projectile jellybean containment 	Sector ID: 155
Name: biohazardous plastic grass sales 	Sector ID: 462
Name: military grade colorful egg user testing 	Sector ID: 266
Name: military grade flower reacquisition 	Sector ID: 176
Name: fuzzy candy coating management 	Sector ID: 475
Name: projectile candy training 	Sector ID: 959
Name: consumer grade basket logistics 	Sector ID: 644
Name: biohazardous candy coating operations 	Sector ID: 434
Name: corrosive flower customer service 	Sector ID: 496
Name: fuzzy corrosive bunny analysis 	Sector ID: 187
Name: magnetic candy design 	Sector ID: 267
Name: top secret basket laboratory 	Sector ID: 171
Name: military grade rabbit deployment 	Sector ID: 827
Name: international flower operations 	Sector ID: 684
Name: radioactive egg deployment 	Sector ID: 582
Name: fuzzy chocolate shipping 	Sector ID: 223
Name: projectile flower design 	Sector ID: 195
Name: consumer grade egg receiving 	Sector ID: 419
Name: biohazardous candy training 	Sector ID: 864
Name: international rampaging rabbit analysis 	Sector ID: 287
Name: unstable rabbit shipping 	Sector ID: 482
Name: international candy coating receiving 	Sector ID: 550
Name: top secret bunny analysis 	Sector ID: 680
Name: military grade basket receiving 	Sector ID: 931
Name: unstable corrosive candy coating department 	Sector ID: 617
Name: unstable plastic grass marketing 	Sector ID: 271
Name: consumer grade basket development 	Sector ID: 362
Name: colorful bunny receiving 	Sector ID: 791
Name: top secret flower workshop 	Sector ID: 920
Name: classified dye reacquisition 	Sector ID: 752
Name: projectile plastic grass marketing 	Sector ID: 444
Name: military grade basket services 	Sector ID: 379
Name: fuzzy chocolate engineering 	Sector ID: 252
Name: classified basket user testing 	Sector ID: 509
